WE /Users/megen/wrekspace/ary_cub3d/map.cub  

C         122,255,122 

R   300                         720     

NO /Users/megen/wrekspace/ary_cub3d/map.cub  
                            SO              /Users/megen/wrekspace/ary_cub3d/map.cub  
   EA  /Users/megen/wrekspace/ary_cub3d/map.cub    

F       0,0,0   


S /Users/megen/wrekspace/ary_cub3d/map.cub  


        1111111111111111111111111
        1000000000110000000000001
        1011000001110000002000001
        1001000000000000000000001
111111111011000001110000000000001
100000000011000001110111111111111
11110111111111011100000010001
11110111111111011101010111111
11000000110101011100001
10002000000000001100000111111 
10000000000000001101010010001
11000001110101011111011110N0111
11110111 1110101 101111010001
11111111 1111111 111111111111


